NO textures/walls/greystone.xpm
SO textures/walls/redbrick.xpm
WE textures/walls/purplestone.xpm
EA textures/walls/wood.xpm
D textures/doors/door.xpm
F 70,70,70
C 20,30,40

111111111
100000001
1111D1111
1000N0001
100000001
111111111
