NO textures/walls/wall_N.xpm
SO textures/walls/wall_S.xpm
WE textures/walls/wall_W.xpm
EA textures/walls/wall_E.xpm
D textures/doors/door.xpm
F 30,160,90
C 30,30,80

1111111111
1000000001
1011111101
1001000101
1011010101
10E0010001
1111111111
