NO textures/walls/wall_N.xpm
SO textures/walls/wall_S.xpm
WE textures/walls/wall_W.xpm
EA textures/walls/wall_E.xpm
D textures/doors/door.xpm
F 70,145,70
C 120,185,255

1111111111111111111111111111111
1000000000000000000000000000001
1011110111111110111111110111101
1000010100000010000000010100001
1011010101111010111111010101101
1010010101000010100000010100101
1011110101011110101111010111101
1000000101000000101000010000001
1111011101110111101011110111101
1001000000010100001000000100101
1011011111010101111011110101101
100001000000E00D000000010000001
1011110111110101111011110111101
1000000100010100000010000100001
1011111101010111111010111101111
1000000001010001000010100000001
1111110101011101011110101111101
1000000101000101000010100000101
1011110101110101111010111110101
1000010000010000000010000010001
1011011111011111111011111011101
1000000000000000000000000000001
1111111111111111111111111111111
