NO textures/walls/wall_N.xpm
SO textures/walls/wall_S.xpm
WE textures/walls/wall_W.xpm
EA textures/walls/wall_E.xpm
D textures/doors/door.xpm
F 180,120,40
C 90,140,220

111111111
100000001
101110101
10W000001
101011101
100000001
111111111
