NO textures/wall_N.xpm
SO textures/wall_S.xpm
WE textures/wall_W.xpm
EA textures/wall_E.xpm
D textures/doors/door.xpm

F 220,100,0
C 225,30,0
1111111111111111111111111
1000000000110000000000001
1011000001110000000000001
100100000000000000000000111111111
111111111011000001110000000000001
10000000001100000111011111D111111
11110111111111000000000000001
11110111111111011101010010001
110000001101010111000000D0001
10000000000000001100000010001
100000000000000011010100D0001
11000001110101011111010010N01
11110111 1110101 101110010001
11111111 1111111 111111111111
