NO mlx/test/open.xpm
SO mlx/test/open24.xpm
WE mlx/test/open30.xpm
EA mlx/test/open.xpm
F 220,100,0
C 120,120,255

111111
1000 1
10N001
100001
111111
