NO README.md
SO README.md
WE README.md
EA README.md
F 100,100,100
C 20,20,20

111111
100001
100N01
100001
111111
