NO textures/walls/greystone.xpm
SO textures/walls/redbrick.xpm
WE textures/walls/purplestone.xpm
EA textures/walls/wood.xpm
F 220,100,0
C 120,120,255

1111111
1A00001
100N001
1111111
