NO textures/walls/greystone.xpm
SO textures/walls/redbrick.xpm
WE textures/walls/purplestone.xpm
EA textures/walls/wood.xpm
F 220,100,0
C 120,120,255

111111
10N001
100S01
111111
