NO textures/walls/greystone.xpm
SO textures/walls/redbrick.xpm
NO textures/walls/wood.xpm
WE textures/walls/purplestone.xpm
EA textures/walls/wood.xpm
F 220,100,0
C 120,120,255

111111111
100000001
100N00001
100000001
111111111
