NO textures/walls/greystone.xpm
SO textures/walls/redbrick.xpm
WE textures/walls/purplestone.xpm
EA textures/walls/wood.xpm
D textures/doors/door.xpm
F 220,100,0
C 120,120,255

111111111
100000001
1000D0001
1000N0001
100000001
111111111
